
Alligator mississippiensis - American Alligator

Alligator sinensis - Chinese Alligator

Caiman crocodilus – Brillekaiman

Caiman latirostris - Bredsnudet kaiman

Caiman yacare - Yacare kaiman

Crocodylus acutus - Amerikansk krokodille

Crocodylus cataphractus – Panserkrokodille

Crocodylus intermedius – Orinocokrokodille

Crocodylus johnsoni – Ferskvandskrokodille

Crocodylus mindorensis - Filippinsk krokodille

Crocodylus moreletii - Bredsnudet krokodille

Crocodylus niloticus – Nilkrokodille

Crocodylus novaeguineae - Ny Guinea krokodille

Crocodylus palustris – Sumpkrokodille

Crocodylus porosus – Saltvandskrokodille

Crocodylus rhombifer - Cuba krokodille

Crocodylus siamensis - Siamesisk krokodille

Osteolaemus tetraspis - Dværg krokodille

Gavialis gangeticus – Cavial

Melanosuchus niger - Sort kaiman

Palaeosuchus palpebrosus - Cuviers dværgkaiman

Palaeosuchus trigonatus - Schneiders kaiman

Tomistoma schlegelii – Tomistoma



Skildpadder:

Podocnemis expansa – Arrauenskildpadde

Carettochelys insculpta – Flodskildpadde

Chelodina longicollis – Slangehalsskildpadde

Geochelone sulcata – Sporeskildpadde

Podocnemis unifilis – Terecayskildpadde

Phrynops hilarii – Tudsehovedskildpadde



Øgler:

Iguana iguana - Grøn leguan

Varanus Salvadorii - krokodille varan



Slanger:

Eunectes murinus - Grøn anakonda

Python molurus – Tigerpython



Padder:

Litoria caerulea – Koralfingerløvfrø



Fugle:

Ara militaris – Soldaterara



Pattedyr:

Neofelis nebulosa - Træleopard

Dasypus novemcinctus - Bæltedyr

Saguinus oedipus - Paryktamarin